Wozu: For what purpose / Why
Werbung: Advertising / Advertisement
Konsum: Consumption
Mittagspause: Lunch break
Tankstelle:  Gas station / Petrol station
Fernsehapparat:  Television set
Dachwohnung: Attic apartment
besitze: Own 
Sachen: Things / Stuff
Bürostress: Office stress
abhängig: Dependent / Addicted
minimalistisch: Minimalistic
Geduld: Patience
Überstunden: Overtime
enttaüscht: Disappointed ("enttäuschen")("hat enttaüscht")
Ordner: Folder 
Gegenstand: Object 
erleichtern: To make easier / To facilitate
Vorteil: Advantage / Benefit
loben:  To praise
ordentlich: Tidy / Neat / Proper
erzählen:  To tell / To narrate
schick und hübsch: Chic and pretty
anzuprobieren: To try on
Irgendetwas: Something / Anything
Beschäftigungen: Activities
Koffer: Suitcase
Gewöhnlich: Usually / Normally
Wegwerfen: To throw away
unbedingt: Absolutely / Definitely
abfalleimer: Trash can / Garbage bin
ausleeren: To empty
bekannter:  Acquaintance / Friend
Freude:  Joy / Pleasure
Referat:  Presentation / Report
Bremsen:  To brake / Brakes
verzichten: To forgo 
ausruhen: To rest