Optische Täuschung: Optical illusion
Künstliche: Artificial
Ratgeber: Guide, self-help book
Lüge: lie
Wahrheit: truth
her.stellen: Manufactures, produces ("hat hergestellt")
Hausbesitzer: Homeowner
entscheiden: decide ("hat entschieden")
enttäuschen: disappoint ("hat enttäuscht")
Heraus.finden: To find out, to discover ("hat herausgefunden")
stimmen: vote, tune("hat gestimmt")
Kunstfleisch: Lab-grown meat, artificial meat
Zellen: Cells
Zellhaufen: Zellhaufen
verbinden: to Connect, link ("hat verbunden")
Rücken: Back (body part)
nehmen: take ("hat genommen")
Jahrzehntelang: for decades
forschen:  carry on research ("hat geforscht")
gelingen: be successful ("ist gelungen")
Kuhmist: Cow manure
füttern: feed ("hat gefüttert")
teilen: divide, share, partition ("hat geteilt")
einzeln: Individual, each
riechen: smell ("hat gerochen")
braten: fry, roast ("hat gebraten")
überzeugen: convince ("hat überzeugt")
retten: to save ("hat gerettet")
Erde: Earth, soil
dagegen:  Against it, on the other hand
Hauptursache: Main cause, reason
Klimawandel: Climate change
Tatsache: Fact
allerdings: However, though
Vorstellung: Idea, imagination, performance
echt: Real
beruhigen: To calm ("hat beruhigt")
täuschen: deceive, mislead ("hat getäuscht")
Nahrungsmittel: Food
wachsen: grow ("ist gewachsen")
roh: raw
kisten: box, crate
ausleihen:  To borrow, to lend
abwaschen: To wash
aufstellen: To set up
anmachen: To turn on, to light
Grillkohle: charcoal
besorgen: To get, to obtain
wegräumen: To put away, to clear away
Nachtisch: Dessert
Zettel: Note, piece of paper
unterlagen: Documents, paperwork
verlieren: To lose ("hat verloren")
klappen: go smoothly, work out ("hat geklappt")
zweifellos: Undoubtedly, without a doubt
selbstverständlich: Of course, naturally
anscheinend: Apparently
offenbar: Obviously, evidently
tatsächlich: Actually, really
angeblich: Allegedly
eventuell: Possibly, maybe
Eindruck: Impression
Ente: Duck 
Kreuz: Cross
Tuch: towel
Knödel: Dumpling
Schlange: queue
Fliege: : Fly (the insect) 
Sprichwort:  Proverb, saying
Arten: Types, species
Standpunkt: Point of view
unterstützen:  To support
vor.kommen: To occur, to happen, to appear ("ist vorgekommen")
Rechnen: To calculate, to count
notwendig: Necessary
Passant: pedestrian
tippen: guess, type ("hat getippt")
einige: several
lösen: To solve, to resolve
Umfrage:Survey
stellen: place ("hat gestellt")
folgende: The following
magische: Magical
Würstchen: Sausage
frisst: Eats (used for animals)
Zahl: Number
verdoppeln: to double
Zugstrecke: Train route
insgesamt: Overall, in total
Verlust: loss
Aktien: stocks
Bankberater: Bank advisor
Notendurschschnitt: Grade point average (GPA)