  
Erinnern (sich): To remember
Kinderwagen: Stroller
Zelten: To camp
Aufgepasst: take care
Aufregend: Exciting
einschlafen: To fall asleep
Aufführung: Performance
stumm: Mute
Geräuschermacher: Noise maker
Handwerker:  Craftsman
Filmgeräusche: Film sounds
beeindruckend: awesome, impressive
Zuschauer: Spectator
Werkzeugen: Tools
Hörerlebnis: Listening experience
Kinobesuch: English visit to the cinema
Filmgeschichte: Film history
entstanden: Originated ("entstehen")("ist entstanden")
nötig: Necessary
Toningenieur: Toningenieur
verantwortlich: Responsible
künstler: Artist
verwenden: To use
Handlung: Plot
schritte: Steps
Klang: sound
niemals: Never
konzentriert (sich): Concentrated ("konzentrieren")
Geräusche: Sounds
zuerst: First
gestellt: Placed/ asked ("gestellen")("hat gestellt")  
wirkung: Effect
fertiegen: To manufacture/To make
verlassen: To leave
komplizierte: ("komplizieren")("hat kompliziert") Complicated
erledigen: To accomplish/To complete
Zeitungen: Newspapers
Gegenstände: Objects
Kokosnüsse: Coconuts
Lippen: Lips
Filmgeschäft: Film industry
Aktionszene: Action scene
Zeichentrickfiguren:  Cartoon characters
unmögliche: Impossible
achten: To pay attention
erraten: To guess
Fabrik: Factory
spiegeleier: Fried eggs
braten: To fry/To roast
bringen: ("hat gebracht")
Rennen: run
atmen: breath 
wirft: Throws ("werfen") ("hat geworfen")
ab·heben: Withdraw ("hat abgehoben")
schlagen: hit ("hat geschlagen")
Geburtstagstorte: birthday cake
aus·blasen: puff out("hat ausgeblasen")
Kerze: candle
fallen: ("ist gefallen")
Boden: Floor/Ground
aufschlägt: Hits
Plastikfolie: Plastic wrap
zerdückt: Crushed ("zerdrücken")("hat zerdrückt")
Kamin: Fireplace
brennt: burn ("brennen")("hat gebrannt")
Weintrauben: Grapes
Lederhandschuhe: Leather gloves
hintereinander: In a row
hohe: High
Gebäude: building
wertvoll: valuable
Regentropfen: Raindrops
Tonbänder: Tape recordings
Ermäßigung: Discount
Eintrittskarte: Admission ticket
reiten und springen: To ride (a horse) and To jump
ernähren: To nourish / To feed
erholen (sich): To recover / To relax
Reitstunden:  Riding lessons
faulenzen: To laze around / To lounge
erfolgreich: Successful
beliebt: Popular
Gegenteil: Opposite
reinste: Purest
Gesicht: face
Schlafstörungen:  Sleep disorders
Unfall: Accident
Chemiefabrik: Chemical factory
Psychisch: Psychological
Krankheit: Illness / Disease
merkwürdige: Strange / Odd
Schließlich: Finally / Eventually
Zweifel: Doubt
geschehen: To happen / To occur
offenbar: Apparently
Beziehung: Relationship
leidet: Suffers ("hat gelitten")
begesitert: Excited 
witzig: Funny 
unsichtbar: Invisible
Heimatfilm:
Sehenswürdigkeiten: Sights / Attractions
Streit: Argument / Conflict
Brand: fire
Bauernhof: Farm
gestorben: Died ("sterben")("ist gestorben")
schuld: Guilt / Fault
beendet: Finished / Ended ("beenden") ("hat beendet")
Rat: Advice
behinderte: Disabled (people)
Tod: Death
vor.bereiten: To prepare
gewöhnen: To get used to
Heimweh: Homesickness
unterhalten: To entertain
inzwischen:  Meanwhile / In the meantime
heimlich: Secretly
zurückglassen: Left behind
angenommen: Accepted / Assumed ("an·nehmen")("hat angenommen")
sorgen: To care for ("hat gesorgt")
Geschäftsmann: Businessman
erscheint: Appears 
verlässt: leave ("verlassen")("hat verlassen")
bequeme: Comfortable
ärgert: Annoys / Angers ("ärgern")("hat geärgert")
Empfang: Reception
Tal: valley
nun: Now 
überzeugen: To convince / To persuade
abzureisen: To depart / To leave (on a trip)
Veranstaltung: Event 
stören: To disturb / To bother
auftauchen: To appear / To emerge
werben: To advertise / To promote
einig: United / In agreement
Zorn: Anger
fliehen: To escape
Wie kommt man am schnellsten vom Flughafen in die Stadt?
Indem man die U-Bahn nimmt.
indem sie ganz einfache Werkzeuge verwenden.
stumm + der Film --> der Stummfilm
der Film + die Aufführung --> die Filmaufführung