Vorbild: Role model
Begeistert: Enthusiastic
Entdeckte: Discovered
Emanzipierte: Emancipated
Ansichten: Views or opinions
Umsonst: Free
Vor allem: Above all
Übrigens: By the way
Begegnet: Met or encountered
Dankbar: Grateful
Stolz: Proud
Sogar: Even
Strafen: Penalties/Punishments
Trägt: Carries/Bears ("tragen")
Selbstverständlich: Naturally/Of course
Erklärt: Explains ("erklären")
Beschäftigt: Busy or occupied
Dauernd: Constantly
Werkstatt: Workshop
Geräten: Devices or equipment
Gebastelt: Crafted or tinkered ("basteln")
Unvergesslich: Unforgettable
Erlebnis: Experience
Demonstrationen: Demonstrations
Atomkraft: Nuclear power
Beteiligt: Involved
Friedensmärschen: Peace marches
Mitgemacht: Participated
Aufregendste: Most exciting
Verbrachte: Spent ("verbringen")
Kindheit: Childhood
Unterrichtete: Taught ("unterrichten")("hat unterrichtet")
Unterstützte: Supported ("unterstützen")
Auswanderer: emigrants
Erhielt: Received ("erhalten")("hat erhalten")
Weigerte sich: Refused ("weigern")("habe geweigert")
Veröffentlichte: Published ("veröffentlichen") ("hat veröffentlicht")
Unvergesslich: unforgettable
Entwickelte: Developed
Feierte: Celebrated
Protestierte: Protested
Weltkrieg: World War
Auftrat: Occured, Appeared ("auf·treten")("ist aufgetreten")
Annahm: Accepted or assumed
Staatsbürgerschaft: Citizenship
Beleidigt: Insulted or offended ("beleidigen")("hat beleidigt")
Beschimpfe: to insult
Beschädigt: Damaged
Anschreit: Yells at ("an·schreien") ("hat angeschrien ")
Vorhabe: Intend or plan
Treiben: to do
einschalten: to turn on
an.zünden: to light
Wirken: To have an effect / to work
Feststellen: To determine / to find out ("hat festgestellt")
Regelmäßig: Regularly
Ordnung hält: Keeps things in order
Häufig: Frequently
Eindeutig: Clearly / unequivocally
Aufgab: Gave up ("auf·geben")("hat aufgegeben")
Einfluss: Influence
Schwierigen: Difficult
Geschieden: Divorced
Ging: went
Bergab: Downhill
Gezeigt: Showed
Unten: Below
Gelungen: Succeeded ("gelingen") ("ist gelungen")
Abzuschließen: To complete
Griff: Grabbed
Schaffen: To create or to manage
Begleitet: Accompanied ("hat begleitet")
Geloht: Was worth it
Anziehen: get dressed ("hat angezogen")
auf·nehmen: record ("hat aufgenommen") 
Lebensabschnitt: Phase of life
weiter·kommen: move forward ("ist weitergekommen")
Entschlossen: decide ("entschließen")
Ausgeschlossen: Excluded
Überhaupt: At all / anyway
Ausgekannt:be familiar (with) aus·kennen ("hat ausgekannt")
Mitgenommen: Taken along
Riesiger: Huge
Endgültig: Final
Weggeben: To give away ("hat weggegeben")
Gestiegen: Risen ("steigen")("ist gestiegen")
Gezogen: Moved ("ziehen")("ist gezogen")