Wüstentour: Desert tour
Boot: Boat
Salzwüsten: Salt deserts
aufwärts: Upwards
Polarmeer: Polar sea
Kreuzfahrt: Cruise
beobachten: To observe, to watch
Tierarten: Animal species
streng: Strict
schützen: to Protect ("hat geschützt")
Löwe: Lion
Segelschiff: Sailing ship
unterwegs: On the way
Einreisegenehmigung: Entry permit, Authorisation to enter the country 
höher: Higher
zurückzahlen: To pay back
Auftrag: order, mission, task, assignment
Wohnungsbau: Housing construction
an·treten: begin, start ("angetreten")
Fremde: stranger, foreigner
Auswanderen:  To emigrate
Heim: Home
Aussicht: View, outlook
Vergnügen: Pleasure, enjoyment
führt: Leads, guides ("hat geführt")
Unglück: Misfortune, accident
retten: save from; rescue ("hat gerettet")
Ferne: Distance, far away
überraschen: To surprise
Löhne: Wages, salaries
bestätigen: To confirm
eigentümer: Owner
leihen: borrow, lend ("hat geliehen")
Gründe: Reasons
mangel: Lack, shortage
Arbeitsbedingungen: Working conditions
Armut: Poverty
zuletzt: Lastly
Herausforderung: Challenge
annehmen: to accept, to assume
bemühen: to make an effort
Absicht: Intention, purpose
aufzubauen: To build up, to establish
tätig: Active, employed, working
Überzeugung: Conviction, belief
vor·stellen: imagine, introduce ("hat vorgestellt")
beantragen: apply for ("hat beantragt")
erledigen: finish, complete ("hat erledigt")
aus·füllen: fill in, complete, fill out ("hat ausgefüllt")
etliche: Several, quite a few
Amtsweg: official procedure
aufträge: Orders, assignments, tasks
dutzende: Dozens
verlieben: ("hat verlieben")
kehren: return
innerhalb: within
Allerdings: However, indeed, though
überleben: survive ("hat überlebt")
Überfahrt: Crossing, passage (usually refers to a journey across water)
einige: Some
Schiffsbesitzer: Shipowner
Speise: Food, dish
anstrengend: Exhausting, tiring
unterhaltsam: Entertaining, amusing
damals: Back then, at that time
gering: Low, small, minimal
niedrig: Low (often used for levels, prices, or amounts)
Lebenshaltungskosten: Cost of living
Haushaltsgeräte: Household appliances
sparsam: Economical
preiswert: Inexpensive, reasonably priced
günstig: Affordable, favorable
witzig: Funny
sauber: Clean
zuvärlässig: Reliable
vernünftig: Sensible, reasonable
Entstehen: arise
Gastgeber: host
Festlegen: To determine, to set, to establish ("festgelegt")
oberhalb: above
unterhalb: below, bneath
außerhalb: outside
innerhalb: within
Fluss: River
Kreuzung:  Intersection, crossroads
abbiegen: To turn
Treffpunkt: Meeting point
ziemlich: Quite, fairly, rather
hinaus: Out, outside
auf·wachsen: grow up ("ist aufgewachsen")
Hafenstadt: Port city
Strandbäder: Beach resorts
Kreideküste: Chalk coast
Schiff: Ship
Kontinent: Continent
steilen: Steep 
Bergbach: mountain stream
nerven: annoy, bother ("hat genervt")
menschenleer: empty, uninhabited
selten: rare, seldom
Pflanze: plant
hinauf: Up, upwards
gegend: Area, region
gletscher: glacier
bergwiese: mountain meadow
hügel: Hill
Weinberg: Vineyard
ufer: Shore
rund: Round, approximately









Wann?
innerhalb einesMonats / ... (genetive)
innerhalb von zwei Monaten / ... (dative)

Während sie essen, suchen sie ein Couch im Internet.
Nachdem sie gegessen haben, suchen sie ein Couch im Internet.
Bevor sie essen, suchen sie ein Couch im Internet.
